1111111111111111111111111111111111111111111111111111111111111111
1000000000000000000000000000000000000000000000000000000000000001
1000000000000000000000000000000000000000000000000000000000000001
1000000000000000000000000000000000000000000000000000000000000001
10000000p0000000000000000000000000000000000000000000000000000001
1000000000000000000000000000000000000000000000000000000000000001
1000000000000000000000000000000000000000111111000000000000000001
1002222222222200000000000000000000000000000000000000000000000001
100000000000000000000000s000000000000000000000000000000000000001
1000000000000000000111111111110000000000000000000022200000000001
1000000000000000000000000000000000000000000000000000000000000001
10000000000000000s00000000000000000022222222200000000000s0000001
1000000000000000000000000000000000000000000000000000000000000001
1000000000000000000000000000000000000000000000000000000000000001
1000000000001111111100000000222222200000000000011111111111111301
100000000000000000000000s000000000000000000000000000000000000301
100000000000000000000000000000000000000000s000000000000000000301
10000000000000000000011111110000s0000002222220000000000000000301
1000000000000000000000000000000000000000000000000000000000000301
1000000000000000000000000000000111110000000000000000000000000301
1000000111111100000000000000000000000000000000000000000000000301
1000000000000000000000000000000s00000000022222200000000000000301
1000000000000000000000000000000000000000000000000000000000000301
1000000000001111111100000000222222200000000000011111111111000301
100000000000000000000000s00000000000000000s000000000000000000301
10000000000000000000000000000000s0s00000000000000000000000000301
100000000000000000000111111100000d000002222220000000000000000301
1000000000000000000000000000000000000000000000000000000000000301
1000000000000000000000000000000111110000000s00000000000000000301
1000000111111100000000000000000000000000000000000000000000000301
100000000000000000000000s000000000000000022222200000000000000301
1000000000000000000000000000000000000000000000000000000000000301
1000000000000022222222222222200000000000000000000000000000000301
1000000000000000000000000000000000000000000000000000000000000301
1000000000000000000000000000000000011111111111111100000000000301
1000000001000000000000000000000000000000000000000000000000000301
1000000000000000000000000000000000000000000000000000000000000301
1000000000002000000000000000000000000000000000000000000002200301
1000000000000000000000000000000000000000000000000000000000000301
1000000000000000002000000000011000000000000000001111000000000301
1000000000000000000000000000000000000000000000000000000000000301
1000000000000000000000000000000000000000020000000000000000000301
1000000000001000000000000000000000000000000000000000000000000301
1000000000000000000000002200000000000000000000000000000000000301
1000000000000000000000000000000000000000000000000000000000000301
1000000000000000000000000000000000000010000000000000000000000301
1000000000000000000000000000000000000000000000000000000000000301
1000000000000000011000000000000000000000000000000000000000000301
1000000000000000000000000000000000022000000000000000000000000301
1000002220000000000000000000000000000000000000000000000000000301
1000000000000000000000000000000000000000000000000000000000000301
1111111111111111111111111111111111111111111111111111111111111111