11111111111111111111111111111111111111111111111111111111111111111111111111111111111111111111111111111111111111111111111111111111
10000000000000000000000000000000000000000000000000000000000000000000000000000000000000000000000000000000000000000000000000000001
10000000000000000000000000000000000000000000000s000000000000000000000000000000000000s0000000000000000000000000000000000000000001
100000p0000000000000000000000000000000000000000000000000000000000000000000000022222222222222000000000000000000000000000000000001
1000000000000000000000000000000000000032222222222222200000000000s000000000000000000000000000000011100000000000000000000000000001
100002222222222220000000s0000000000000300000000000000000000000000000000000000000000000000000000000000000000000000000000000000001
10000000000000000000000000000000000000300000000000000000000111111111110000000000000000000000000000000000022222222222222000000001
10000000000000000000001111110000000000300000000000000000000000000000000000000000000000000000011000000000000000000000000000000001
10000000000000000000000000000000000000000000000000000000000000000000000000000000000000000000000s00000000000000000000000000000001
10000000000000000000000000000000000000000000000000000000000000000000000000000000000000000000000000000000000000000000000000000001
10000000000000000000000000000022220000000000000000000000000000000000000000000000000000000002222222200000000000000000000000000001
100000000000000000000200000000000000000s0000000000000000000000000000000000000000000000000000000000000000000000000000000000000001
1000000000000000000000000000000000000000000000000000000000s00000000s000000000000000000000000000000000001110000000000000000000001
10000000000000011000000000000000000001111111000000000000000000000000000000000000111111111000000000000000000000000000000000000001
100000000000000000000000s0000000000000000000000000000000000000000000000000000000000000000000000000000000000000000000000000000001
10000000000000000000000000000000000000000000000002222222222222222222222222230000000000000000000000002222222222222222322222200001
10000000000000000000011111111000000000000000000000000000000000000000000000030000000000000000000000000000000000000000300000000001
100000000000s0000000000000000000000000000000000000000000000000000000000000030000000000000000000010000000000000000000300000000001
10000000000000000000000000000000000000000000000000000000000000000000000000030000000000000000000000000000000000000000300000000001
10000002222222222222000000000000000000000000000000000000000000000000000000030000000000000000000000000000000000000000300000000001
10000000000000000000000000000000000000000000000000000000000000000000000000030000000000000002000000000000000000000000300000000001
10000000000000000000000000000000000000001000000000200000000000000000000000030000000000000000000000000000000000000000300000000001
1000000000000000000000000000000000000000000000000000000000010000000s000000030000000000000000000000000000000000000000300000000001
10000000000000000000000000000000000000000000000000000000000000000000000000030000001111110000000000000000000000000000300000000001
10000000000000000000000000000000002000000000000000000000000000000022220000030000000000000000000000000000000000000000300000000001
10000000000000000000000000000000000000000000000000000000000000000000000000030000000000000000000000000000000000000000300000000001
10000000000000000000000000000000000000000000000000000000000000000000000000030000000000000000000000000002222200000000300000000001
10000000000000000000000000000000000000000000000000000000000000000000000000030000000000000000000000000000000000000000300000000001
10000000000000000000000000001000000000000000000000000000000000000000000000030000000000000000000000000000000000000000300000000001
10000000000000000000000000000000000000000000000000000000000000s000000s0000030000000000000000000000000000000000000000300000000001
10000000000000000220000000000000000000000000000000000000000000000000000000030000000000000000000000000000000000000000300000000001
10000000000000000000000000000000000000000000000000000000000000000000000000030000000000000000000000000000000000000000300000000001
10000000000000000000000000000000000000000000000000000011111111111111111111111111111113000000000000000000000000000000300000000001
10000000000000000000000000001000000000000000000000000000000000000000000000000000000003000000000000000000000000000000300000000001
10000000000000000000000000000000000000000000000000000000000000000000000000000000000000000000000000000000000000000000300000000001
1000000000000000000000000000000000000200000000000000000000000d000000000000000000000000000000000000000000000000000000300000000001
10000000000000000000000000000000000000000000000000000000002222222000000000000000000000000000000000000000000000000000300000000001
10000000000000000000000000000100000000000000000000000000000000000000000000000000001000000000000000000000000000000000300000000001
10000000000000000000000000000000000000000000000000000000000000000000000000000000000000000000000000000000000000000000300000000001
10000000000000000000000000000000000000200000000000000010000000000000000000000000000000000000000000000000000000000000300000000001
10000000000000000000000000000000000000000000000000000000000000000000000000000000000000000000000000000000000000000000300000000001
10000000000000000000000000000000000000000000000000000000000000000000000000222220000000000000000000000000000000000000300000000001
10000000000000000000000000000000000000000000000000000000000000000000000000000000000000000011111111000000000000000000300000000001
10000000000000000000000000000000000000000000000000000000000000000000000000000000000000000000000000000000000000000000300000000001
10000000000000000000000000000000000000000000000000000000000000000000000000000000000000000000000000000022222000000000300000000001
10000000000000000000000000000000000000000000000000000000000000000000000000000000000000000000000000000000000000000000300000000001
10000000000000000000000000000000000000000000000000000000000000000000000000000000000000000000000000000000000000000000300000000001
10000000000000000000000000000000000000000000000000000000000000000000000000000000000000000000000000000000000000000000300000000001
11111111111111111111111111111111111111111111111111111111111111111111111111111111111111111111111111111111111111111111111111111111