11111111111111111111111111111111
10000000p00000000000000000000001
10000000000000000000000000000001
10000001111111111111110000000001
10000000000000000000000000000001
10000000000000000000000000000001
10000000000000000000000000000001
10000000000000000000000000000001
10000000000000011111111111111101
10000000000000000000000000000001
10000000000000000000000000000001
10011111111111111100000000000001
10000000000000000000000000000001
10000000000000000000000000000001
10000000000000000000000000000001
10000000000001111111111111110001
10000000000000000000000000000001
10000000000000000000000000000001
10000000000000000000000000000001
10001111111111111110000000000001
10000000000000000000000000000001
10000000000000000000000000000001
10000000000000000000000000000001
11111111111111111111111111111111