11111111111111111111111111111111111111111111111111
1000000000000000000000d000000000000000003000000001
100000p0000000000000000000000000000000003000000001
10000000000000011111111111111110000000003000000001
10000000000000000000000000000000000000003000000001
10000000000000000000000000000000000000003000000001
10000000000000000000222222222222222200003000000001
10000000000000000000000000000000000000003000000001
10000000000000000000000000000000000000003000000001
10000000000000011111111111111110000000003000000001
10000000000000000000000000000000000000003000000001
10000000000000000000000000000000000000003000000001
10000000000000000000222222222222222200003000000001
10000000000000000000000000000000000000003000000001
10000000000000000000000000000000000000003000000001
10000000000000011111111111111110000000003000000001
10000000000000000000000000000000000000003000000001
10000000000000000000000000000000000000003000000001
10000000000000000000222222222222222200003000000001
10000000000000000000000000000000000000003000000001
10000000000000000000000000000000000000003000000001
10000000000000011111111111111110000000003000000001
10000000000000000000000000000000000000003000000001
10000000000000000000000000000000000000003000000001
10000000000000000000222222222222222200003000000001
10000000000000000000000000000000000000003000000001
10000000000000000000000000000000000000003000000001
10000000000000011111111111111110000000003000000001
10000000000000000000000000000000000000003000000001
10000000000000000000000000000000000000003000000001
10000000000000000000222222222222222200003000000001
10000000000000000000000000000000000000003000000001
10000000000000000000000000000000000000003000000001
10000000000000011111111111111110000000003000000001
10000000000000000000000000000000000000003000000001
10000000000000000000000000000000000000003000000001
10000000000000000000222222222222222200003000000001
10000000000000000000000000000000000000003000000001
10000000000000000000000000000000000000003000000001
10000000000000011111111111111110000000003000000001
10000000000000000000000000000000000000003000000001
10000000000000000000000000000000000000003000000001
10000000000000000000222222222222222200003000000001
10000000000000000000000000000000000000003000000001
10000000000000000000000000000000000000003000000001
10000000000000011111111111111110000000003000000001
10000000000000000000000000000000000000003000000001
10000000000000000000000000000000000000003000000001
10000000000000000000222222222222222200003000000001
10000000000000000000000000000000000000003000000001
10000000000000000000000000000000000000003000000001
10000000000000011111111111111110000000003000000001
10000000000000000000000000000000000000003000000001
10000000000000000000000000000000000000003000000001
10000000000000000000222222222222222200003000000001
10000000000000000000000000000000000000003000000001
10000000000000000000000000000000000000003000000001
10000000000000011111111111111110000000003000000001
10000000000000000000000000000000000000003000000001
10000000000000000000000000000000000000003000000001
10000000000000000000222222222222222200003000000001
10000000000000000000000000000000000000003000000001
10000000000000000000000000000000000000003000000001
10000000000000011111111111111110000000003000000001
10000000000000000000000000000000000000003000000001
10000000000000000000000000000000000000003000000001
10000000000000000000222222222222222200003000000001
10000000000000000000000000000000000000003000000001
10000000000000000000000000000000000000003000000001
10000000000000011111111111111110000000003000000001
10000000000000000000000000000000000000003000000001
10000000000000000000000000000000000000003000000001
10000000000000000000222222222222222200003000000001
10000000000000000000000000000000000000003000000001
10000000000000000000000000000000000000003000000001
10000000000000011111111111111110000000003000000001
10000000000000000000000000000000000000003000000001
10000000000000000000000000000000000000003000000001
10000000000000000000222222222222222200003000000001
10000000000000000000000000000000000000003000000001
10000000000000000000000000000000000000003000000001
10000000000000011111111111111110000000003000000001
10000000000000000000000000000000000000003000000001
10000000000000000000000000000000000000003000000001
10000000000000000000222222222222222200003000000001
10000000000000000000000000000000000000003000000001
10000000000000000000000000000000000000003000000001
10000000000000011111111111111110000000003000000001
10000000000000000000000000000000000000003000000001
10000000000000000000000000000000000000003000000001
10000000000000000000222222222222222200003000000001
10000000000000000000000000000000000000003000000001
10000000000000000000000000000000000000003000000001
10000000000000011111111111111110000000003000000001
10000000000000000000000000000000000000003000000001
10000000000000000000000000000000000000003000000001
10000000000000000000222222222222222200003000000001
10000000000000000000000000000000000000003000000001
10000000000000000000000000000000000000003000000001
10000000000000011111111111111110000000003000000001
10000000000000000000000000000000000000003000000001
10000000000000000000000000000000000000003000000001
10000000000000000000222222222222222200003000000001
10000000000000000000000000000000000000003000000001
10000000000000000000000000000000000000003000000001
10000000000000011111111111111110000000003000000001
10000000000000000000000000000000000000003000000001
10000000000000000000000000000000000000003000000001
10000000000000000000222222222222222200003000000001
10000000000000000000000000000000000000003000000001
10000000000000000000000000000000000000003000000001
10000000000000011111111111111110000000003000000001
10000000000000000000000000000000000000003000000001
10000000000000000000000000000000000000003000000001
10000000000000000000222222222222222200003000000001
10000000000000000000000000000000000000003000000001
10000000000000000000000000000000000000003000000001
10000000000000011111111111111110000000003000000001
10000000000000000000000000000000000000003000000001
10000000000000000000000000000000000000003000000001
10000000000000000000222222222222222200003000000001
10000000000000000000000000000000000000003000000001
10000000000000000000000000000000000000003000000001
10000000000000011111111111111110000000003000000001
10000000000000000000000000000000000000003000000001
10000000000000000000000000000000000000003000000001
10000000000000000000222222222222222200003000000001
10000000000000000000000000000000000000003000000001
10000000000000000000000000000000000000003000000001
10000000000000011111111111111110000000003000000001
10000000000000000000000000000000000000003000000001
10000000000000000000000000000000000000003000000001
10000000000000000000222222222222222200003000000001
10000000000000000000000000000000000000003000000001
10000000000000000000000000000000000000003000000001
10000000000000011111111111111110000000003000000001
10000000000000000000000000000000000000003000000001
10000000000000000000000000000000000000003000000001
10000000000000000000222222222222222200003000000001
10000000000000000000000000000000000000003000000001
10000000000000000000000000000000000000003000000001
10000000000000011111111111111110000000003000000001
10000000000000000000000000000000000000003000000001
10000000000000000000000000000000000000003000000001
10000000000000000000222222222222222200003000000001
10000000000000000000000000000000000000003000000001
10000000000000000000000000000000000000003000000001
10000000000000011111111111111110000000003000000001
10000000000000000000000000000000000000003000000001
10000000000000000000000000000000000000003000000001
10000000000000000000222222222222222200003000000001
10000000000000000000000000000000000000003000000001
10000000000000000000000000000000000000003000000001
10000000000000011111111111111110000000003000000001
10000000000000000000000000000000000000003000000001
10000000000000000000000000000000000000003000000001
10000000000000000000222222222222222200003000000001
10000000000000000000000000000000000000003000000001
10000000000000000000000000000000000000003000000001
10000000000000011111111111111110000000003000000001
10000000000000000000000000000000000000003000000001
10000000000000000000000000000000000000003000000001
10000000000000000000222222222222222200003000000001
10000000000000000000000000000000000000003000000001
10000000000000000000000000000000000000003000000001
10000000000000011111111111111110000000003000000001
10000000000000000000000000000000000000003000000001
10000000000000000000000000000000000000003000000001
10000000000000000000222222222222222200003000000001
10000000000000000000000000000000000000003000000001
10000000000000000000000000000000000000003000000001
10000000000000011111111111111110000000003000000001
10000000000000000000000000000000000000003000000001
10000000000000000000000000000000000000003000000001
10000000000000000000222222222222222200003000000001
10000000000000000000000000000000000000003000000001
10000000000000000000000000000000000000003000000001
10011111111111111000000000000000000000003000000001
10000000000000000000000000000000000000003000000001
10000000000000011111111111111110000000003000000001
10000000000000000000000000000000000000003000000001
10000000000000000000000000000000000000003000000001
10000000000000000000222222222222222200003000000001
10000000000000000000000000000000000000003000000001
10000000000000000000000000000000000000003000000001
10000000000000011111111111111110000000003000000001
10000000000000000000000000000000000000003000000001
10000000000000000000000000000000000000003000000001
10000000000000000000222222222222222200003000000001
10000000000000000000000000000000000000003000000001
10000000000000000000000000000000000000003000000001
11111111111111111111111111111111111111111111111111