1111111111111111111111111111111111111111111111111111111111111111
1000000000000000000000000000000000000000000000000000000000000001
1000000000000000000000000000000000000000000000000000000000000001
1000000000000000000000000000000000000000000000000000000000000001
1000p00000000000000000000000000000000000000000000000000000000001
1000000000000000000000000000000000000000000000000000000000000001
1000000000000000000000000000000000000000111111000000000000000001
1002222202222200000000000000000000000000000000000000000000000001
1000000202000000000000000000000000000000000000000000000000000001
1000000202000000000111111111110000000000000000000022200000000001
1000000202000000000000000000000000000000000000000000000000000001
1000000020000000000000000000000000002222222220000000000000000001
1000000000000000000000000000000000000000000000000000000000000001
1000000000000000000000000000000000000000000000000000000000000001
1000000000001111111100000000222222200000000000011111111111000001
1000000000000000000000000000000000000000000000000000000000000001
1000000000000000000000000000000000000000000000000000000000000001
1000000000000000000001111111000000000002222220000000000000000001
1000000000000000000000000000000000000000000000000000000000000001
1000000000000000000000000000000111110000000000000000000000000001
1000000111111100000000000000000000000000000000000000000000000001
1000000000000000000000000000000000000000022222200000000000000001
1000000000000000000000000000000000000000000000000000000000000001
1000000000001111111100000000222222200000000000011111111111000001
1000000000000000000000000000000000000000000000000000000000000001
1000000000000000000000000000000000000000000000000000000000000001
1000000000000000000001111111000000000002222220000000000000000001
1000000000000000000000000000000000000000000000000000000000000001
1000000000000000000000000000000111110000000000000000000000000001
1000000111111100000000000000000000000000000000000000000000000001
1000000000000000000000000000000000000000022222200000000000000001
1000000000000000000000000000000000000000000000000000000000000001
1000000000000022222222222222200000000000000000000000000000000001
1000000000000000000000000000000000000000000000000000000000000001
1000000000000000000000000000000000011111111111111100000000000001
1000000001000000000000000000000000000000000000000000000000000001
1000000000000000000000000000000000000000000000000000000000000001
1000000000002000000000000000000000000000000000000000000002200001
1000000000000000000000000000000000000000000000000000000000000001
1000000000000000002000000000011000000000000000001111000000000001
1000000000000000000000000000000000000000000000000000000000000001
1000000000000000000000000000000000000000020000000000000000000001
1000000000001000000000000000000000000000000000000000000000000001
1000000000000000000000000000000000000000000000000000000000000001
1000000000000000000000000000000000000000000000000000000000000001
1000000000000000000000000000000000000000000000000000000000000001
1000000000000000000000000000000000000000000000000000000000000001
1000000000000000001000000000000000000000000000000000000000000001
1000000000000000000000000000000000000000000000000000000000000001
1000002000000000000000000000000000000000000000000000000000000001
1000000000000000000000000000000000000000000000000000000000000001
1111111111111111111111111111111111111111111111111111111111111111